111111111111111111
100100000000E00001
100000000000000001
1000000000000A0001
110000000000000001
100001000000000001
100000110000000001
1000000000C0000001
11000000A000000001
100000001000000001
10000P000000000001
100000000000000001
111111111111111111
